....................
....................
....................
.......~~~~~~.......
..p..............p..
~~~~..p.p.p.p....~~~
.......p.p.pep......
......~~~~~~~~......
...~~.::::::::..~~..
......::::::::......
.p.p..::::::::..p.p.
~~~~..::::::::..~~~~
......::::::::......
.1....::::::::......
####################
