....................
....................
..........X.........
.......######.......
..j..............j..
####..j.j.j.j....###
.......j.j.jCj......
......--------......
...--...........--..
....................
.j.j............j.j.
####............####
....................
.1..................
####################
