....................
....................
....................
.......~~~~~~.......
..P..............P..
~~~~..P.P.P.P....~~~
.......P.P.PEP......
......~~~~~~~~......
...~~...........~~..
....................
.P.P............P.P.
~~~~............~~~~
....................
.1..................
####################
