....................
....................
..........X.........
.......######.......
..J..............J..
####..J.J.J.J....###
.......J.J.JCJ......
......--------......
...--...........--..
....................
.J.J............J.J.
####............####
....................
.1..................
####################
