....................
...p................
...~~..p.......~~...
....p.~~........p...
...~~..........~~...
...p......p....p....
...~~....~~....~~...
....p...........p...
...~~........p.~~...
...p........~~.p....
...~~.......::.~~...
...:P.......::..p...
...~~.......::.~~...
.1.::.......::.::...
####################
