....................
...P................
...~~..P.......~~...
....P.~~........P...
...~~..........~~...
...P......P....P....
...~~....~~....~~...
....P...........P...
...~~........P.~~...
...P........~~.P....
...~~..........~~...
....P...........P...
...~~..........~~...
.1..................
####################
