....................
...J............X...
...--..J.......--...
....J.--........J...
...--..........--...
...J......J....J....
...--....--....--...
....J...........J...
...--........J.--...
...J........--.J....
...--..........--...
....J...........J...
...--..........--...
.1..................
####################
