....................
...j................
...~~..j.......~~...
....j.~~........j...
...~~..........~~...
...j......j....j....
...~~....~~....~~...
....j...........j...
...~~........j.~~...
...j........~~.j....
...~~..........~~...
....j...........j...
...~~..........~~...
.1..................
####################
