....................
...j............X...
...--..j.......--...
....j.--........j...
...--..........--...
...j......j....j....
...--....--....--...
....j...........j...
...--........j.--...
...j........--.j....
...--..........--...
....j...........j...
...--..........--...
.1..................
####################
